OOOOOOOOOO
O O    O O
O . OO   O
O O O   XO
O OOOO O.O
O O      U
O OOOOOO.O
O O      O
O O OOOOOO
O .      O
OOOOOOOOOO